##########
#P     * #
### ##   #
#        #
#   # #XE#
#   ##   #
# # ## # #
#      # #
# ## #X# #
# #     ##
#   *    #
##########
