##########
#P     * #
### ##   #
#        #
#   # #X #
#   ##   #
# # ## # #
#      # #
# ## #X# #
# #     ##
#   *   E#
##########
