##########
#P     * #
# ## ##  #
#        #
# #  # #E#
# # ## # #
#      # #
# ## #X# #
# #     ##
#   *    #
##########
