##########
#####*# E#
# * #    #
##       #
#        #
#  X ##  #
# ########
#   ##   #
#P    *  #
##########