##########
#####*##P#
# * ###  #
##       #
#       ##
#  X ##  #
# ########
#   ##   #
#     * E#
##########